1, 0, 58, 36, 13, 00, 0, 0, 0, 0, 1
1, 0, 12, 1, 1, 1, 1, 1, 12, 0, 1
1, 0, 1, 1, 1, 1, 1, 1, 1, 0, 1
1, 0, 1, 1, 1, 33, 1, 1, 1, 0, 1
1, 0, 1, 1, 1, 15, 1, 1, 1, 0, 1
1, 0, 11, 1, 1, 61, 1, 1, 11, 0, 1
1, 0, 20, 20, 1, 62, 1, 20, 20, 0, 1
1, 0, 20, 20, 1, 61, 1, 20, 20, 0, 1
1, 0, 20, 20, 1, 3, 1, 20, 20, 0, 1
1, 68, 69, 68, 3, 00, 3, 68, 69, 68, 1
1, 1, 1, 1, 1, 14, 1, 1, 1, 1, 1