20, 20, 20, 20, 20, 00, 14, 20, 20, 20, 20
20, 20, 20, 20, 20, 0, 20, 20, 20, 20, 20
20, 20, 20, 20, 20, 0, 20, 20, 20, 20, 20
20, 20, 20, 20, 1, 4, 1, 20, 20, 20, 20
20, 20, 20, 1, 26, 0, 1, 1, 20, 20, 20
20, 20, 20, 1, 1, 53, 1, 1, 20, 20, 20
20, 20, 20, 1, 1, 00, 1, 1, 20, 20, 20
20, 20, 20, 1, 1, 13, 1, 1, 20, 20, 20
20, 20, 20, 20, 1, 1, 1, 20, 20, 20, 20
20, 20, 20, 20, 20, 20, 20, 20, 20, 20, 20
20, 20, 20, 20, 20, 20, 20, 20, 20, 20, 20