20, 20, 20, 20, 20, 20, 20, 20, 20, 20, 20
20, 20, 20, 20, 20, 20, 20, 20, 20, 20, 20
20, 20, 20, 20, 20, 20, 20, 20, 20, 20, 20
20, 20, 20, 20, 1, 1, 1, 20, 20, 20, 20
20, 20, 20, 1, 1, 28, 1, 1, 20, 20, 20
20, 20, 20, 1, 1, 15, 1, 1, 20, 20, 20
20, 20, 20, 1, 1, 4, 1, 1, 20, 20, 20
20, 20, 20, 20, 1, 4, 1, 20, 20, 20, 20
20, 20, 20, 20, 20, 20, 20, 20, 20, 20, 20
20, 20, 20, 20, 20, 20, 20, 20, 20, 20, 20
14, 00, 0, 0, 0, 0, 0, 0, 0, 00, 13