0, 0, 0, 0, 0, 0, 0, 0, 0, 0, 0
0, 20, 0, 20, 20, 20, 20, 20, 0, 20, 0
0, 20, 0, 20, 20, 20, 20, 20, 0, 20, 0
0, 20, 0, 20, 20, 13, 20, 20, 0, 20, 0
0, 20, 0, 20, 20, 00, 20, 20, 0, 20, 0
0, 20, 53, 20, 20, 0, 20, 20, 53, 20, 0
0, 20, 15, 20, 20, 59, 20, 20, 15, 20, 0
0, 20, 75, 20, 20, 15, 20, 20, 80, 20, 0
0, 20, 20, 20, 20, 0, 20, 20, 20, 20, 0
0, 20, 20, 20, 20, 0, 20, 20, 20, 20, 0
0, 0, 0, 0, 0, 0, 0, 0, 0, 00, 14