58, 0, 0, 10, 10, 10, 0, 0, 20, 0, 12
0, 20, 20, 20, 20, 20, 20, 0, 3, 0, 20
10, 20, 20, 57, 58, 58, 58, 0, 20, 0, 20
10, 20, 20, 30, 20, 20, 20, 20, 20, 0, 20
0, 57, 20, 20, 20, 20, 20, 20, 39, 0, 20
20, 4, 59, 15, 202, 20, 20, 39, 3, 00, 14
0, 57, 20, 20, 20, 20, 20, 20, 39, 0, 20
10, 20, 20, 30, 20, 20, 20, 20, 20, 0, 20
10, 20, 20, 57, 58, 58, 58, 0, 20, 0, 20
0, 20, 20, 20, 20, 20, 20, 0, 3, 0, 20
58, 0, 0, 10, 10, 10, 0, 0, 20, 0, 12