0, 1, 1, 9, 66, 1, 66, 10, 1, 1, 0
0, 0, 1, 1, 2, 1, 2, 1, 1, 0, 52
0, 0, 0, 0, 0, 1, 0, 0, 0, 52, 12
0, 1, 0, 1, 1, 1, 1, 1, 0, 1, 1
48, 1, 0, 0, 6, 6, 6, 0, 0, 1, 6
49, 1, 0, 1, 1, 1, 1, 2, 1, 1, 6
48, 1, 0, 0, 00, 14, 1, 0, 2, 49, 0
0, 1, 1, 1, 1, 1, 1, 2, 1, 1, 0
0, 1, 11, 9, 10, 1, 0, 49, 0, 1, 6
00, 1, 11, 9, 10, 4, 60, 1, 60, 1, 6
13, 1, 11, 9, 10, 1, 7, 1, 7, 1, 11