0, 67, 0, 0, 0, 0, 0, 1, 0, 61, 0
0, 1, 1, 1, 1, 1, 2, 1, 0, 1, 0
0, 1, 0, 0, 68, 0, 0, 1, 0, 1, 0
12, 1, 4, 1, 1, 1, 0, 1, 0, 1, 0
54, 1, 0, 0, 61, 1, 68, 1, 10, 1, 0
55, 1, 0, 62, 15, 1, 69, 1, 10, 1, 0
54, 1, 61, 15, 26, 1, 68, 1, 10, 1, 9
0, 1, 1, 1, 1, 1, 0, 1, 0, 1, 9
0, 54, 0, 1, 0, 0, 0, 61, 0, 1, 9
1, 1, 0, 1, 12, 1, 1, 1, 1, 1, 0
14, 00, 0, 3, 00, 13, 1, 31, 62, 2, 0