14, 1, 0, 55, 0, 1, 10, 9, 6, 8, 1
00, 1, 9, 1, 12, 1, 10, 9, 6, 7, 1
0, 1, 6, 1, 6, 1, 10, 9, 6, 54, 1
0, 1, 6, 1, 6, 1, 1, 1, 1, 2, 1
0, 1, 0, 1, 0, 0, 0, 2, 0, 0, 1
0, 1, 2, 1, 1, 2, 1, 1, 2, 1, 1
0, 5, 0, 0, 0, 0, 1, 0, 54, 0, 1
0, 1, 2, 1, 1, 3, 1, 15, 1, 15, 1
0, 1, 6, 1, 12, 11, 1, 0, 1, 0, 1
00, 1, 6, 1, 12, 11, 1, 0, 1, 0, 1
13, 1, 10, 1, 12, 11, 1, 26, 1, 27, 1