70, 10, 50, 11, 62, 8, 62, 11, 50, 10, 70
12, 20, 6, 20, 7, 20, 7, 20, 6, 20, 12
20, 9, 50, 0, 58, 0, 58, 0, 50, 9, 20
11, 20, 6, 20, 0, 14, 0, 20, 6, 20, 11
62, 7, 58, 0, 0, 00, 0, 0, 58, 7, 62
8, 20, 0, 20, 0, 20, 0, 20, 0, 20, 8
62, 7, 58, 0, 0, 0, 0, 0, 58, 7, 62
11, 20, 6, 20, 0, 0, 0, 20, 6, 20, 11
20, 9, 50, 0, 58, 0, 58, 0, 50, 9, 20
12, 20, 6, 20, 7, 20, 7, 20, 6, 20, 12
70, 10, 50, 11, 62, 8, 62, 11, 50, 10, 70